111111111111111111111111111111
1..........1    1..........1
1....C.....1    1.....E....1
1..........1    1..........1
111111D11111    11111D111111
1                          1
1            P             1
1                          1
111111D11111    11111D111111
1..........1    1..........1
1....J.....1    1.....K....1
1..........1    1..........1
111111111111111111111111111111