11111111111111111
1.................1
1..E.....E....E..1
1..o...D...o.....1
1.................1
1..o.....o....o..1
1......T..T......1
1.......P.........1
1....o........o..1
1.................1
11111111111111111