111111111111111
11..o...o...11
1.....E.......1
1...o..D..o...1
1.....E.......1
11..o...o...11
1.......P.....1
111111.11111111