111111111111111
11...........11
1.............1
1......D......1
1.............1
11...........11
1.......P.....1
111111.11111111