111111111111111
1.1..o...o..1.1
1.....E.......1
1..o...B...o..1
1.....E.......1
1.1..o...o..1.1
1.......P.....1
111111.11111111