111111111111111
1..o.....o....1
1..1111.1111..1
1...o..C..o...1
1..1111.1111..1
1....o.....o..1
1.......P.....1
111111.11111111