11111111111111111
1.................1
1....11111.11111..1
1..o..o...A...o..o1
1.................1
1...E.....E.....E.1
1.............TT..1
1....o...........o1
1.......P.........1
1...o.....o....o..1
1.................1
11111111111111111