111111111111111
1..o...o...o..1
1.............1
1...o..A..o...1
1.............1
1..o...o...o..1
1.......P.....1
111111.11111111