11111111111111111
1..E.....E......1
1...o.......o...1
1..E...B...E....1
1................1
1..o.....TTT..o..1
1......E....E....1
1........P.......1
1...o..........o.1
1................1
11111111111111111