1111111111111111111111111111
1..........1    1..........1
1....A.....1    1.....B....1
1..........1    1..........1
11111...1111    1111...11111
1                          1
1            P             1
1                          1
11111...1111    11111.111111
1..........1    1..........1
1....C.....1    1.....D....1
1..........1    1..........1
1111111111111111111111111111