1111111111111111111111111111
1..o..o..o.1    1..o..o..o.1
1..o..A..o.1    1..o...B..o1
1..o..o..o.1    1..o..o..o.1
11111..11111    11111..11111
1                          1
1            P             1
1                          1
11111..11111    11111..11111
1..o..o..o.1    1..o..o..o.1
1..o..C..o.1    1..o...D..o1
1..o..o..o.1    1..o..o..o.1
1111111111111111111111111111